MAZE: "mylevel", ' '
FLAGS:premapped
GEOMETRY:center,center

MAP
   |||         |||
   |.|         |.|
   |.|||||||||||.|
   |...........|.|
   |.....|||||||.|
|||||||..|..|....|
|........|..|....|
|..||...........||
|...|..|||||..||| 
|..||||| | |....||
|...|..|||||||...|
|............|...|
|||||........|||.|
    ||.||.||...|.|
|||||..........|.|
|.|...||||||...|||
|...|.|    |...|  
|||||||    |||||  
ENDMAP

STAIR:(14, 16),down
BRANCH: (9,7,9,7),(10,8,10,8)
