
MAZE: "mylevel", ' '
FLAGS:premapped
GEOMETRY:center,center

MAP
|||||||||||||
|.|.|.|.|...|
|.|.|...|...|
|.|.|...|...|
|.|.....|...|
|...........|
|...........|
|..|||...||||
|....|......|
|..|||||.|..|
|....|...|.||
|....|...|..|
|||||||||||||
ENDMAP

STAIR:(4, 10),down
BRANCH: (11,1,11,1),(12,2,12,2)
