
MAZE: "mylevel", ' '
FLAGS:premapped
GEOMETRY:center,center

MAP
|||||||||||||
|...........|
|...........|
|...........|
|...........|
|...........|
|...........|
|...........|
|...........|
|...........|
|...........|
|...........|
|||||||||||||
ENDMAP

STAIR:(11, 1),down
BRANCH: (1,11,1,11),(2,12,2,12)