
MAZE: "mylevel", ' '
FLAGS:premapped
GEOMETRY:center,center

MAP
|||||||||||||
|....|......|
|..|.|.||||||
|..|.|.|....|
|..|.|.||||.|
||||.|......|
|....|.||||||
|||..|..|.|.|
|...|||.|.|.|
|...........|
|.|||||||||||
|...........|
|||||||||||||
ENDMAP

STAIR:(11, 1),down
BRANCH: (1,1,1,1),(2,2,2,2)
