
MAZE: "mylevel", ' '
FLAGS:premapped
GEOMETRY:center,center

MAP
|||||||||||||||
|.|.|.|.|.|.|.|
|.............|
|.|||||||||||||
|.|.|.|.|.|.|.|
|.............|
|||||||||||||.|
|.|.|.|.|.|.|.|
|.............|
|||||||||||||||
ENDMAP

STAIR:(13, 1),down
BRANCH: (1,8,1,8),(2,9,2,9)