
MAZE: "mylevel", ' '
FLAGS:premapped
GEOMETRY:center,center

MAP
|||||||||||||
|...........|
|.|||||||||||
|.|.|.|.|.|.|
|...........|
|||||||||||.|
|.|.|.|.|.|.|
|...........|
|||||||||||||
ENDMAP

STAIR:(11, 1),down
BRANCH: (1,7,1,7),(2,8,2,8)
